############################################################################
............................................................................
............................................................................
............................................................................
............................................................................
............................................................................
............................................................................
............................................................................
............................................................................
............................................................................
............................................................................
............................................................................
............................................................................
............................................................................
............................................................................
............................................................................
............................................................................
............................................................................
............................................................................
...h........................................................................
............................................................................
............................................................................
............................................................................
....#.....#.....#.....#.....#.....#.....#.....#.....#.....#.....#.....#....f
....|a----|a----|a----|a----|a----|a----|a----|a----|a----|a----|a----|a---f
....||....||....||....||....||....||....||....||....||....||....||....||...f
....||....||....||....||....||....||....||....||....||....||....||....||...f
#---------------------------------------------------------------------------
|...........................................................................
|...........................................................................
