############################################################################
............................................................................
............................................................................
............................................................................
............................................................................
............................................................................
............................................................................
............................................................................
............................................................................
............................................................................
............................................................................
............................................................................
............................................................................
............................................................................
............................................................................
............................................................................
............................................................................
............................................................................
...h..............#--------.................................................
.................A|...........W.............................................
.......#--________............#---------....#-______....#-______....#-______
..........W...........W.......................W...........W...........W.....
....#.....#.....#.....#.....#.....#.....#.....#.....#.....#.....#.....#....f
....|a----|a----|a----|a----|a----|a----|a----|a----|a----|a----|a----|a---f
....||....||....||....||....||....||....||....||....||....||....||....||...f
....||....||....||....||....||....||....||....||....||....||....||....||...f
....||....||....||....||....||....||....||....||....||....||....||....||...f
#---------------------------------------------------------------------------
|...........................................................................
|...........................................................................