#############################################
.............................................
......................................f......
......................................f......
......................................f......
......................................f......
......................................#######
.............................................
.............................................
...h.........................................
......................................f......
......................................f......
......................................f......
......................................f......
#######...............................#######
.............................................
.............................................
.............................................
......................................f......
......................................f......
......................................f......
......................................f......
......................................#######
.............................................
.............................................
.............................................
.............................................
a--------------------------------------------
|............................................
#--------------------------------------------
