............................................................................
............................................................................
............................................................................
............................................................................
............................................................................
.........................##########.........................................
.........................##..#..............................................
.........................#####..............................................
.........................##.................................................
............................................................................
............................................................................
............................................................................
............................................................................
............................................................................
............................................................................
..............#####..#.##.....####..#..#..#..#..............................
..............#.#.#..#..#.....#.....#..#..##.#..............................
..............#.#.#..#####....#..#..#..#..#.##..................##########..
..............#...#..#...#....####..####..#..#..............................
............................................................................
............####################################............................
...........#....................................#...........................
..h.......#......................................#..........................
.........#........................................#.........................
........#..........................................#........................
.......#............................................#.......................
......#..............................................#......................
............................................................................
............................................................................
............................................................................
